111111111111111111111111111111111111111111111111111111111111
1000000000000000000000000000000000000000000000000000000000E1
100000000000000011111110000000000000000111111111111111000001
100000000000000111111100111000000000011111111111111111100001
100000000000001100000000111000000000111000000000000111000001
100000000000011000000000111000000001110000000000001111000001
100000000000110000000000111000000011100000000000011110000001
100000000001100000000000111000000111100000000000111100000001
100000000011000000000000111000000111100000000001111000000001
100000000110000000000000111000000111100000000011110000000001
100000001100000000000000111000000000000000000111100000000001
100000011000000000000000111000000000000000001111000000000001
100000110000000000000000111000000000000000011110000000000001
100001100000000000000000111000000000000000111100000000000001
100011000000000000000000111000000000000001111000000000000001
100011111111111111111111111111100000000011110000000000000001
100011111111111111111111111111100000000111100000000000000001
100000000000000001000000111000000000001111000000000000000001
100000000000000000100000111000000000011110000000000000000001
100000000000111111000000111000000000111100000000000000000001
100000000000000000000000111000000001111000000000000000000001
100000000000000000000000111000000011110000000000000000000001
100000001110000000000000111000000111100000000000000000000001
100000000000001000000000111000001111000000000000000000000001
100000010000010000000100111000011110000000000000000000000001
100001000100000000011000111000111100000000000000000000000001
100000100010000000000000111000111111111111111111111111000001
100000100000000000000000111000111111111111111111111111000001
100001000000000000000000000000000000000000000000000000000001
111000000000000000000000000000000000000000000000000000000001
1P000000000000000000000000C000000000000000000000000000000001
111111111111111111111111111111111111111111111111111111111111
