111111111111111111111111111111111111111111111111111111111111
1000000000000000000000000000011100000000000000000000000000E1
100000000000000011111110000000000000000111111111111111000001
100000110000000111111100111000100000011111111111111111100001
100000000000001100000000111000110000111000000000000111000001
100001100000011000000000111000010001110000000000001111000001
100000100000110000000000111001000011100000000000011110000001
1001000000011000000000001110010001111000000C0000111100000001
100110000011000000000000111000000111100000000001111000000001
101000000110000000000000111000000111100000000011110000000001
100000001100000000000000111000000000000000000111100000000001
100000011000000C00000000111000000000000000001111000000000001
100000110000000000000000111000111000000000011110000000000001
10000110000000000000C00011100000011100000011110000C000000001
100011000000000000000000111000000000000001111000000000000001
10001111111111111111111111111110000000001111000000000C000001
100011111111111111111111111111100000000111100000000000000001
100000000000000001000000111000000000001111000000000000000001
100000000000000000100000111000000000011110000000100000000001
100000000000111111000000111000011000111100000010000000000001
100000000000000000000000111000111001111000000000000000000001
100000000000000000000000111000000011110000000111100000000001
100000001110000000000000111000000111100000000000000000000001
1000000000000010000C0000111000001111000000000000000000000001
100000010000010000000100111000011110000000000000000000000001
100001000100000000011000111000111100000000000000000000001001
100000100010000000000000111000111111111111111111111111000111
100000100000000000000000111000111111111111111111111111000111
100001000000000000000000000000000000000110000000000000000001
1P000000000000000000000000C000000000000000000010000010000001
111111111111111111111111111111111111111111111111111111111111
