1111111111111
1000000000001
1000010000001
1000000001001
1111111111111
