1111111111111
100100C0000C1
1000111111001
1P0011E0000C1
1111111111111
