1111111111111
1001100C0000C1
100100C0000C1
100100C0000C1
100100C0000C1
100100C0000C1
100100C0000C1
1000011111001
1P0011E0000C1
1111111111111
